11111111111111111111-
11111111111111111111-
10000000000111111111-
00000000000000000001-
00000000000000000000-
00111111110000000000-
00000000011111111110-
00000000000000000000-
10000000000000000000-
11111111000000000001-
11111111111111111111