000000000000000000000-
000000000000000000000-
001000000000000000100-
001000011111111000100-
001000010000001000100-
001000010000001000100-
001000010001111000100-
001000010001000000100-
001000010001000000100-
001000010001000000100-
001000010001000000100-
001000010001000000100-
001111110001111111100-
000000000000000000000-
000000000000000000000-
000000000000000000000