00000000000000000000-
00111111111111111100-
00000000000000222100-
00000000000000222100-
00000000000000222100-
00111111111111111100-
00122200000000000000-
00122200000000000000-
00122200000000000000-
00111111111111111100-
00000000000000222100-
00000000000000222100-
00000000000000222100-
00111111111111111100-
00100000000000000000-
00100000000000000000-
00100000000000000000-
00111111111111111100-
00000000000000000000