00000000000000000000-
00111111111111111100-
00122200000000000100-
00111111111111122100-
00000000000000122100-
00000000000000122100-
00111111111111122100-
00000000000000000100-
00000000000000000100-
00111111111111111100-
00100000000000000000-
00100011111022211110-
00100010001022210010-
00100010001022210010-
00111110001111110010-
00000000000000000000