000000000000000000000-
000000000000000000000-
000000000000000000000-
000002200000000000000-
011111111111111111110-
000000000000000220000-
000000000000000000000-
000000000000000000000-
222222222222222222222-
222222222222222222222-
222222222222222222222